


SO ./textures/greystone.xpm

 NO ./textures/mossy.xpm
 	C 200,	0, 150

			  F 150,   150,		254

   		WE ./textures/colorstone.xpm

EA	 	 ./textures/purplestone.xpm
        1111111111111111111111111
        1000000000110000000000001
       1011000001110000000000001
       1001000000000000000000001
11111111101100N001110000000000001
100000000011000001110111111111111
11110111111111011100000010001
11110111111111011101010010001
 1100000011010101110000001001
10000000000000001100000010001
10010000000000011010100100011
110000011101010111110111100111
11110111 1110101 101111010001
11111111 111111 111111111111
